11111111111111111111111111111111111111111111111
1P000000000000000000000000000000000000000000001
10000000000000000000000000000000000000000000001
10000000000000000000000000000000000000000000001
10000000000000000000000000000000000000000000001
10000000000000000000000000000000000000000000001
10000000000000000000000000000000000000000000001
10000000000000000000000000000000000000000000001
10000000000000000000000000000000000000000000001
10000000000000000000000000000000000000000000001
10000000000000000000000000000000000000000000001
10000000000000000000000000000000000000000000001
10000000000000000000000000000000000000000000001
10000000000000000000000000000000000000000000001
10000000000000000000000000000000000000000000001
10000000000000000000000000000000000000000000001
10000000000000000000000000000000000000000000001
10000000000000000000000000000000000000000000001
10000000000000000000000000000000000000000000001
10000000000000000000000000000000000000000000001
10000000000000000000000000000000000000000000001
1000000000000000E000000000111111110000000000001
10000000000000011000000000100000010000000000001
10000000000000111000000000100000010000000000001
10000000000001011000000000000000010000000000001
10000000000010011000000000000000010000000000001
10000000000100011000000000000000C10000000000001
10000000001000011000000000111111110000000000001
10000000011111111000000000100000000000000000001
10000000000000C11000000000100000000000000000001
100000000000000110000000001C0000010000000000001
10000000000000011000000000111111110000000000001
10000000000000000000000000000000000000000000001
10000000000000000000000000000000000000000000001
10000000000000000000000000000000000000000000001
10000000000000000000000000000000000000000000001
10000000000000000000000000000000000000000000001
10000000000000000000000000000000000000000000001
10000000000000000000000000000000000000000000001
10000000000000000000000000000000000000000000001
10000000000000000000000000000000000000000000001
10000000000000000000000000000000000000000000001
10000000000000000000000000000000000000000000001
10000000000000000000000000000000000000000000001
10000000000000000000000000000000000000000000001
10000000000000000000000000000000000000000000001
10000000000000000000000000000000000000000000001
10000000000000000000000000000000000000000000001
10000000000000000000000000000000000000000000001
10000000000000000000000000000000000000000000001
10000000000000000000000000000000000000000000001
11111111111111111111111111111111111111111111111
