11111111111111111
11100001110000111
1100CC00100CC0011
11000000000000011
11100000E00000111
11110000000001111
11111100000111111
11111110P01111111
11111111011111111
11111111111111111