1111111111
1C00P10C01
1000111001
1000000001
1111101101
1C1C001001
1001101001
1000001001
10000E1001
1111111111
